1            111111111111
1                       1
                    m   1
          ss            1
1                       
1                       
1                       1
1   b                   1
1                       1
11111111111111          1
